10
10
1
120
WWWWWWWWWW
WXXXXCXXXW
WXXXXXXXXW
WXXXXXXXXW
WXXXXXXXXW
WXXXXXXXXW
WXXXXXXXXW
WXXXDXXXXW
WXXXXXXEXW
WWWWWWWWWW